NO ./textures/GRAY1.png
SO ./textures/CEMENT2.png
WE ./textures/CEMENT3.png
EA ./textures/GRAY1.png

F 220,100,0
C 225,30,0

1111111111111
1000000010001
10000001 10N1
100000001000111
100000000000000
111111111111111
1000001
111111





