NO textures/MARBLE3.png
SO textures/MARBLE3.png
WE textures/MARBLE2.png
EA textures/MARBLE2.png

F 220,100,0
C 225,30,0

1111111111111
1000000100001
1000000D000S1
1000000100001
1000000000001
1111111111111







