NO ./textures/CEMENT1.png
SO ./textures/CEMENT1.png
WE ./textures/CEMENT1.png
EA ./textures/CEMENT1.png

F 220,100,0
C 225,30,0

        1111111111111111111111111
        1S00000000110000000000001
        1011000001110000000000001
        1001000000000000000000001
111111111011000001110000000000001
10000000001100000111011111D111111
11110111111111011100000010001
11110111111111011101010010001
11000000110101011100000010001
1000000000000000110000010001
100000000000000011010100D0001  1
110000011101010111110111100011101
11110111 1110101 101111010001  1
11111111 1111111 111111111111

