NO textures/MARBLE3.png
SO textures/MARBLE3.png
WE textures/MARBLE2.png
EA textures/MARBLE2.png

F 220,100,0
C 225,30,0

1111111111111
100000DDD0001
10000011110N1
100000001000111
10000000000001
111111111111111
1000001
1111111
