NO textures/MARBLE3.png
SO textures/MARBLE3.png
WE textures/MARBLE2.png
EA textures/MARBLE2.png

F 0,0,0
C 225,30,0

1111111111111
100000DDD0001
10O00011110N1
10O000001000111
100000000000O1
111111111111111
1000001
1111111
