NO ./textures/CEMENT1.png
SO ./textures/CEMENT2.png
WE ./textures/CEMENT3.png
EA ./textures/CEMENT4.png

F 220,100,0
C 225,30,0

        1111111111111111111111111
        1S00000000110000000000001
        1011000001110000000000001
        1001000000000000000000001
111111111011000001110000000000001
10000000001100000111011111D111111
11110111111111011100000010001
11110111111111011101010010001
11000000110101011100000010001
1000000000000000110O00010001
1000000000000000DD01010000001
11000001110101011111011110001
1111O111 1110101 101111010001
11111111 1111111 111111111111


